Subject: you pay too much for meds!
Got a condition?
If you require any of the medications below,
Save up to 80% here:
Http:// www. Lvsdfbefd. Info/92 /
Allergy: claritin - zyrtec
Antibiotic: asacol - ceftin - cipro - tequin
AntI depressant: celexa - effexor - paxil - prozac - remeron - zoloft
Anxiety: buspar - valium - xanax
Arthritis: arava - rheumatrex
Blood pressure: altace - avapro - cardizem - cozaar - flomax - norvasc - plavix
Bone and joint: fosamax
Cancer: nolvadex - purinethol
Cholesterol: lipitor - pravachol - zocor
Diabetes: actos - avandia - glucophage
Hair loss: propecia
Headhache: imitrex
Heart burn: aciphex
Hepatitis b: epivir
Herpes: neurontin
Hiv: retrovir - sustiva - videx - viramune - zerit
Muscle relaxant: soma
Nausea: zofran
Pain relief: bextra - celebrex - vioxx
Seizures: lamictal
Sexual health: cialis - viagra
Skin: oxsoralen
Sleep aid: ambien
Smoking: zyban
Upset stomach: nexium - prevacid - prilosec
Weight loss: meridia
Women' s health: diflucan - evista
Ladybug frogsrugby rhonda barry
Tequila crackerkingdom shawn sarahl wright scubal josh
Ledzep angels jimbo
Center naomiscarlett impala hanna
Asterix flight septembe
Rhonda playercarlos raptor taffy
Roy kissdodgers planet sugar tintin sweety utopia
